TILEMAP
64 5 							-- Size of tile map in tiles
16 16 							-- Tile size & block size
images/background/SceneTesting2/tiles1.png 	-- Tilesheet
8 8 								-- Number of tiles in tilesheet
1111111111111111111111111111111111111111111111111111111111111111
9999999999999999999999999999999999999999999999999999999999999999
AAAAAAAAAAAAAAAAAAAAAAAAAAAAAAAAAAAAAAAAAAAAAAAAAAAAAAAAAAAAAAAA
9999999999999999999999999999999999999999999999999999999999999999
IIIIIIIIIIIIIIIIIIIIIIIIIIIIIIIIIIIIIIIIIIIIIIIIIIIIIIIIIIIIIIII